It's been another productive day at Farset Labs, a perfect little hackerspace tucked away in the corner of Belfast. But you're done for the day and it's time to go home.

Having put on your coat, and shouldered your backpack, you step out the front door with your bicycle (making sure that it's locked behind you). It's a dark evening, but your bike light is bright and warm. You hop on the reliable machine and head home.

Or at least that's the plan. Unfortunately it all goes sideways as you approach the exit from Weaver's Park and try to apply the brakes on your bike to slow down. With a sudden "snap!" one of the levers gives way, and you have a very exciting few seconds as you turn the bike to try to avoid sailing out into the road. Luckily you manage to avoid disaster, and you walk back to the Labs with your bicycle.

You take a moment to catch your breath, as you take off your coat and hang it up. "This is fine", you think. The idea of walking home seems awful, but you're a resourceful sort. And you know you're in the perfect place to come up with an alternative solution. You'll apply your maker expertise, and you'll figure out how to...

ESCAPE FROM FARSET LABS!

Type "help" if you need help.

Escape From Farset Labs
A thrilling tale of derring-do and 3D printers. by Ciaran Conliffe
Release 1 / Serial number 241016 / Inform 7 v10.1.2 / D

Lobby
You are standing in the lobby of Farset Labs. A door to the west leads into the common desks area, and a staircase leads up to the co-working floor. To the south is the exit from the building.

Your coat is hanging on the coat-rack.

Your bicycle is leaning against one of the walls.

On the bicycle is a broken brake lever.

ESCAPE FROM FARSET LABS!

Type "help" if you need help.

Escape From Farset Labs
A thrilling tale of derring-do and 3D printers. by Ciaran Conliffe
Release 1 / Serial number 241011 / Inform 7 v10.1.2 / D

Lobby
You are standing in the lobby of Farset Labs. A door to the west leads into the common desks area, and a staircase leads up to the co-working floor. To the south is the exit from the building.

Your coat is hanging on the coat-rack.

Your bicycle is leaning against one of the walls.

On the bicycle is a broken brake lever.

* * *

ESCAPE FROM FARSET LABS!

Type "help" if you need help.

Escape From Farset Labs
A thrilling tale of derring-do and 3D printers. by Ciaran Conliffe
Release 1 / Serial number 241016 / Inform 7 v10.1.2 / D

Lobby
You are standing in the lobby of Farset Labs. A door to the west leads into the common desks area, and a staircase leads up to the co-working floor. To the south is the exit from the building.

Your coat is hanging on the coat-rack.

Your bicycle is leaning against one of the walls.

On the bicycle is a broken brake lever.

>f
ESCAPE FROM FARSET LABS!

Type "help" if you need help.

Escape from Farset Labs!

Lobby
You are standing in the lobby of Farset Labs. A door to the west leads into the common desks area, and a staircase leads up to the co-working floor. To the south is the exit from the building.

Your coat is hanging on the coat-rack.

Your bicycle is leaning against one of the walls.

On the bicycle is a broken brake lever.

* * *

>restart
It's been another productive day at Farset Labs, a perfect little hackerspace tucked away in the corner of Belfast. But you're done for the day and it's time to go home.

Having put on your coat, and shouldered your backpack, you step out the front door with your bicycle (making sure that it's locked behind you). It's a dark evening, but your bike light is bright and warm. You hop on the reliable machine and head home.

Or at least that's the plan. Unfortunately it all goes sideways as you approach the exit from Weaver's Park and try to apply the brakes on your bike to slow down. With a sudden "snap!" one of the levers gives way, and you have a very exciting few seconds as you turn the bike to try to avoid sailing out into the road. Luckily you manage to avoid disaster, and you walk back to the Labs with your bicycle.

You take a moment to catch your breath, as you take off your coat and hang it up. "This is fine", you think. The idea of walking home seems awful, but you're a resourceful sort. And you know you're in the perfect place to come up with an alternative solution. You'll apply your maker expertise, and you'll figure out how to...

ESCAPE FROM FARSET LABS!

Type "help" if you need help.

Escape From Farset Labs
A thrilling tale of derring-do and 3D printers. by Ciaran Conliffe
Release 1 / Serial number 241012 / Inform 7 v10.1.2 / D

Lobby
You are standing in the lobby of Farset Labs. A door to the west leads into the common desks area, and a staircase leads up to the co-working floor. To the south is the exit from the building.

Your coat is hanging on the coat-rack.

Your bicycle is leaning against one of the walls.

On the bicycle is a broken brake lever.

* * *

>restart
It's been another productive day at Farset Labs, a perfect little hackerspace tucked away in the corner of Belfast. But you're done for the day and it's time to go home.

Having put on your coat, and shouldered your backpack, you step out the front door with your bicycle (making sure that it's locked behind you). It's a dark evening, but your bike light is bright and warm. You hop on the reliable machine and head home.

>y
It's been another productive day at Farset Labs, a perfect little hackerspace tucked away in the corner of Belfast. But you're done for the day and it's time to go home.

Having put on your coat, and shouldered your backpack, you step out the front door with your bicycle (making sure that it's locked behind you). It's a dark evening, but your bike light is bright and warm. You hop on the reliable machine and head home.

Or at least that's the plan. Unfortunately it all goes sideways as you approach the exit from Weaver's Park and try to apply the brakes on your bike to slow down. With a sudden "snap!" one of the levers gives way, and you have a very exciting few seconds as you turn the bike to try to avoid sailing out into the road. Luckily you manage to avoid disaster, and you walk back to the Labs with your bicycle.

You take a moment to catch your breath, as you take off your coat and hang it up. "This is fine", you think. The idea of walking home seems awful, but you're a resourceful sort. And you know you're in the perfect place to come up with an alternative solution. You'll apply your maker expertise, and you'll figure out how to...

ESCAPE FROM FARSET LABS!

Type "help" if you need help.

Escape From Farset Labs
A thrilling tale of derring-do and 3D printers. by Ciaran Conliffe
Release 1 / Serial number 241011 / Inform 7 v10.1.2 / D

Lobby
You are standing in the lobby of Farset Labs. A door to the west leads into the common desks area, and a staircase leads up to the co-working floor. To the south is the exit from the building.

Your coat is hanging on the coat-rack.

Your bicycle is leaning against one of the walls.

On the bicycle is a broken brake lever.

* * *

>inv
You are carrying:
  a some loose change
  a backpack (being worn and open)
    a laptop
    an USB drive

* * *

It's been another productive day at Farset Labs, a perfect little hackerspace tucked away in the corner of Belfast. But you're done for the day and it's time to go home.

Having put on your coat, and shouldered your backpack, you step out the front door with your bicycle (making sure that it's locked behind you). It's a dark evening, but your bike light is bright and warm. You hop on the reliable machine and head home.

>restart
It's been another productive day at Farset Labs, a perfect little hackerspace tucked away in the corner of Belfast. But you're done for the day and it's time to go home.

Having put on your coat, and shouldered your backpack, you step out the front door with your bicycle (making sure that it's locked behind you). It's a dark evening, but your bike light is bright and warm. You hop on the reliable machine and head home.

Or at least that's the plan. Unfortunately it all goes sideways as you approach the exit from Weaver's Park and try to apply the brakes on your bike to slow down. With a sudden "snap!" one of the levers gives way, and you have a very exciting few seconds as you turn the bike to try to avoid sailing out into the road. Luckily you manage to avoid disaster, and you walk back to the Labs with your bicycle.

You take a moment to catch your breath, as you take off your coat and hang it up. "This is fine", you think. The idea of walking home seems awful, but you're a resourceful sort. And you know you're in the perfect place to come up with an alternative solution. You'll apply your maker expertise, and you'll figure out how to...

ESCAPE FROM FARSET LABS!

Type "help" if you need help.
Escape From Farset Labs
A thrilling tale of derring-do and 3D printers. by Ciaran Conliffe
Release 1 / Serial number 240411 / Inform 7 v10.1.2 / D

Lobby
You are standing in the lobby of Farset Labs. A door to the west leads into the common desks area, and a staircase leads up to the co-working floor. To the south is the exit from the building.

Your coat is hanging on the coat-rack.

Your bicycle is leaning against one of the walls.

On the bicycle is a broken brake lever.

* * *

>restart
It's been another productive day at Farset Labs, a perfect little hackerspace tucked away in the corner of Belfast. But you're done for the day and it's time to go home.

Having put on your coat, and shouldered your backpack, you step out the front door with your bicycle (making sure that it's locked behind you). It's a dark evening, but your bike light is bright and warm. You hop on the reliable machine and head home.

Or at least that's the plan. Unfortunately it all goes sideways as you approach the exit from Weaver's Park and try to apply the brakes on your bike to slow down. With a sudden "snap!" one of the levers gives way, and you have a very exciting few seconds as you turn the bike to try to avoid sailing out into the road. Luckily you manage to avoid disaster, and you walk back to the Labs with your bicycle.

You take a moment to catch your breath, as you take off your coat and hang it up. "This is fine", you think. The idea of walking home seems awful, but you're a resourceful sort. And you know you're in the perfect place to come up with an alternative solution. You'll apply your maker expertise, and you'll figure out how to...

ESCAPE FROM FARSET LABS!

Type "help" if you need help.
Escape From Farset Labs
A thrilling tale of derring-do and 3D printers. by Ciaran Conliffe
Release 1 / Serial number 240411 / Inform 7 v10.1.2 / D

Lobby
You are standing in the lobby of Farset Labs. A door to the west leads into the common desks area, and a staircase leads up to the co-working floor. To the south is the exit from the building.

Your coat is hanging on the coat-rack.

Your bicycle is leaning against one of the walls.

On the bicycle is a broken brake lever.

>w
Desk Area
An open area filled with desks and monitors, suitable for sitting and coding. It's normally a lively area, though it's deserted this late. If it's peace and quiet you want, then upstairs from the lobby in the co-working area is a better bet. Various facilities are along the north wall, including the lounge. To the west is the events area, or you can head back east to the lobby.

>e
Lobby
You are standing in the lobby of Farset Labs. A door to the west leads into the common desks area, and a staircase leads up to the co-working floor. To the south is the exit from the building.

Your coat is hanging on the coat-rack.

Your bicycle is leaning against one of the walls.

On the bicycle is a broken brake lever.

>s
You're going nowhere until you've fixed your bike.

>die
That's not a verb I recognise.

>end
That's not a verb I recognise.

>quit
Are you sure you want to quit?

* * *

It's been another productive day at Farset Labs, a perfect little hackerspace tucked away in the corner of Belfast. But you're done for the day and it's time to go home.

Having put on your coat, and shouldered your backpack, you step out the front door with your bicycle (making sure that it's locked behind you). It's a dark evening, but your bike light is bright and warm. You hop on the reliable machine and head home.

>w
Desk Area
An open area filled with desks and monitors, suitable for sitting and coding. It's normally a lively area, though it's deserted this late. If it's peace and quiet you want, then upstairs from the lobby in the co-working area is a better bet. Various facilities are along the north wall, including the lounge. To the west is the events area, or you can head back east to the lobby.

>actions
Actions listing on.

>w
[going west]

Event Area
A large open area. Sometimes it's set up with tables for classes or events but currently it's empty. Various posters line the walls. To the west is the workshop, and back east is the desk area.

A colourful orange and red poster catches your eye.

[going west - succeeded]

>x poster
[examining the BSides Belfast poster]
A poster for BSides Belfast 2023, a local information security conference. It shows a magnificent drawing of a phoenix roosting on the Harland and Woolf cranes that form part of the BSides Belfast logo. It doesn't help you with your current problems, but it does cheer you up to remember there is more to life than this.

[examining the BSides Belfast poster - succeeded]

>x posters
You can't see any such thing.

* * *

>w
Desk Area
An open area filled with desks and monitors, suitable for sitting and coding. It's normally a lively area, though it's deserted this late. If it's peace and quiet you want, then upstairs from the lobby in the co-working area is a better bet. Various facilities are along the north wall, including the lounge. To the west is the events area, or you can head back east to the lobby.

>n
Lounge
The desk area forms a rough L-shape, and this northern part of the L serves as a lounge. There are some very comfortable sofas, and you're tired enough that they look pretty tempting. There's a small tuck shop here for snacks.

A small mini-fridge sits in one corner of the lounge as part of the tuck shop. It contains various soft drinks.

A pile of comics on a table next to some soft seats tempts you.

A green plastic skull grins toothily at you from a shelf.

>read comics
A stack of comics is sitting on the table in the lounge. Some of them you've read, some of them you haven't.

* * *

>n
Lounge
The desk area forms a rough L-shape, and this northern part of the L serves as a lounge. There are some very comfortable sofas, and you're tired enough that they look pretty tempting. There's a small tuck shop here for snacks.

A small mini-fridge sits in one corner of the lounge as part of the tuck shop. It contains various soft drinks.

A pile of comics on a table next to some soft seats tempts you.

A green plastic skull grins toothily at you from a shelf.

>read skull
A green skull, 3D printed in durable plastic. The sight of it suggests a possible solution to your problem.

>read comics
You'd love to sit down and read your way through the stack, but it's getting late and you want to get home.

>take all
stack of comics: They're not yours, so you should leave them for other people to read.
green plastic skull: You couldn't possibly desecrate a fixture of the labs like that.
Club Mate: The honesty system forbids you from taking something without paying for it, and you've left your coins in your coat.

>s
Desk Area
An open area filled with desks and monitors, suitable for sitting and coding. It's normally a lively area, though it's deserted this late. If it's peace and quiet you want, then upstairs from the lobby in the co-working area is a better bet. Various facilities are along the north wall, including the lounge. To the west is the events area, or you can head back east to the lobby.

>w
Event Area
A large open area. Sometimes it's set up with tables for classes or events but currently it's empty. Various posters line the walls. To the west is the workshop, and back east is the desk area.

A colourful orange and red poster catches your eye.

Colourful graffiti is chalked all over the walls.

>take all
There are none at all available!

>w
Workshop
A true maker's paradise, filled with tools and gadgets for crafting electronic devices. There's a small door on the north wall with "NOT FOR STORAGE" written on it.

A toolrack hangs along the eastern wall.

A large 3D scanner sits in one corner of the workshop.

A large 3D printer sits in another corner of the workshop.

The Battlebots Arena lurks between the 3D printer and the 3D scanner.

>take all
There are none at all available!

>x arena
This perspex cube is transported to various locations around Ireland by the HackrBattlebots team for small robotic gladiators to fight it out. DuckBot, a personal favourite, is sitting in the middle of the arena. It doesn't help directly in your current predicament, but it fires up your spirit and inspires you to keep going on.

>n
You can't get the door open because of all the stuff stored in there.

>open door
You can't see any such thing.

* * *

>w
Desk Area
An open area filled with desks and monitors, suitable for sitting and coding. It's normally a lively area, though it's deserted this late. If it's peace and quiet you want, then upstairs from the lobby in the co-working area is a better bet. Various facilities are along the north wall, including the lounge. To the west is the events area, or you can head back east to the lobby.

>w
Event Area
A large open area. Sometimes it's set up with tables for classes or events but currently it's empty. Various posters line the walls. To the west is the workshop, and back east is the desk area.

A colourful orange and red poster catches your eye.

Colourful graffiti is chalked all over the walls.

>examine graffiti
You spy an artistically excellent drawing of the Belfast cranes, destined to vanish when the chalk is cleaned.

>examine graffiti
You spy "Bolster rulez OK". How original.

>examine graffiti
You spy "Art woz here". How original.

>examine graffiti
You see Bob. You hope Bob doesn't see you.

>examine graffiti
You spy an artistically excellent drawing of the Belfast cranes, destined to vanish when the chalk is cleaned.

>examine graffiti
You spy an artistically excellent drawing of the Belfast cranes, destined to vanish when the chalk is cleaned.

I beg your pardon?

I beg your pardon?

>examine graffiti
You spy "Bolster rulez OK". How original.

>examine graffiti
You see Bob. You hope Bob doesn't see you.

>examine graffiti
You spy "Art woz here". How original.

>examine graffiti
You spy "Art woz here". How original.

* * *

>examine graffiti
You see Bob. You hope Bob doesn't see you.

>e
Desk Area
An open area filled with desks and monitors, suitable for sitting and coding. It's normally a lively area, though it's deserted this late. If it's peace and quiet you want, then upstairs from the lobby in the co-working area is a better bet. Various facilities are along the north wall, including the lounge. To the west is the events area, or you can head back east to the lobby.

>n
Lounge
The desk area forms a rough L-shape, and this northern part of the L serves as a lounge. There are some very comfortable sofas, and you're tired enough that they look pretty tempting. There's a small tuck shop here for snacks.

A small mini-fridge sits in one corner of the lounge as part of the tuck shop. It contains various soft drinks.

A pile of comics on a table next to some soft seats tempts you.

A green plastic skull grins toothily at you from a shelf.

>get comics
They're not yours, so you should leave them for other people to read.

>read comics
A stack of comics is sitting on the table in the lounge. Some of them you've read, some of them you haven't.

>read comics
A stack of comics is sitting on the table in the lounge. Some of them you've read, some of them you haven't.

* * *

>w
Event Area
A large open area. Sometimes it's set up with tables for classes or events but currently it's empty. Various posters line the walls. To the west is the workshop, and back east is the desk area.

A colourful orange and red poster catches your eye.

Colourful graffiti is chalked all over the walls.

>w
Workshop
A true maker's paradise, filled with tools and gadgets for crafting electronic devices. There's a small door on the north wall with "NOT FOR STORAGE" written on it.

A toolrack hangs along the eastern wall.

A large 3D scanner sits in one corner of the workshop.

A large 3D printer sits in another corner of the workshop.

The Battlebots Arena lurks between the 3D printer and the 3D scanner.

>open door
You can't get the door open because of all the stuff stored in there.

>n
You can't get the door open because of all the stuff stored in there.

* * *

>w
Workshop
A true maker's paradise, filled with tools and gadgets for crafting electronic devices. There's a small door on the north wall with "NOT FOR STORAGE" written on it.

A toolrack hangs along the eastern wall.

A large 3D scanner sits in one corner of the workshop.

A large 3D printer sits in another corner of the workshop.

The Battlebots Arena lurks between the 3D printer and the 3D scanner.

>x door
You see nothing special about the small door.

>get all
There are none at all available!

>x all
You can't use multiple objects with that verb.

>n
You can't get the door open because of all the stuff stored in there.